Q------------------W
|OoOoOoOoOoOoOoOoOo|
|oQWQWQWQWQWQWQWQWo|
|o||||||||||||||||o|
|oASASASASASASASASo|
|oooooooo12oooooooo|
|oQWQWQWQWQWQWQWQWo|
|o||||||||||||||||o|
|oASASASASASASASASo|
|oooooooo34oooooooo|
|oQWQWQWQPCWQWQWQWo|
|o||||||||||||||||o|
|oASASASASASASASASo|
|oooooooooooooooooo|
A------------------S