Q------------------W
|oooooooooooooooooo|
|oQ--------------Wo|
|o|oooooooooooooo|o|
|o|oQ----------Wo|o|
|o|o|oooooooooo|o|o|
|o|o|oQ------Wo|o|o|
|o|o|o|1234PC|o|o|o|
|o|o|oA------So|o|o|
|o|o|oooooooooo|o|o|
|o|oA----------So|o|
|o|oooooooooooooo|o|
|oA--------------So|
|oooooooooooooooooo|
|OOOQ----------WOOO|
|OOOA----------SOOO|
A------------------S